Rank	Name	Team	League	GP	G	A	PTS	PIM	+/-	PGP	PG	PA	PPTS	PPIM	Proj_PTS/GP
2	Eric Staal	Peterborough Petes	OHL	66	39	59	98	36	21	7	9	5	14	6	NHL [1.0, ...]
3	Nathan Horton	Oshawa Generals	OHL	54	33	35	68	111	6	13	9	6	15	10	NHL [0.6, 0.8)
8	Braydon Coburn	Portland Winter Hawks	WHL	53	3	16	19	147	-15	7	0	1	1	8	NHL [0.4, 0.6)
9	Dion Phaneuf	Red Deer Rebels	WHL	71	16	14	30	185	28	23	7	7	14	34	NHL [0.6, 0.8)
11	Jeff Carter	Soo Greyhounds	OHL	61	35	36	71	55	-5	4	0	2	2	2	NHL [0.6, 0.8)
13	Dustin Brown	Guelph Storm	OHL	58	34	42	76	89	-9	11	7	8	15	6	NHL [0.6, 0.8)
14	Brent Seabrook	Lethbridge Hurricanes	WHL	69	9	33	42	113	-14	0	0	0	0	0	NHL [0.2, 0.4)
16	Steve Bernier	Moncton Wildcats	QMJHL	71	49	52	101	90	33	2	1	0	1	2	NHL [0.4, 0.6)
18	Eric Fehr	Brandon Wheat Kings	WHL	70	26	29	55	76	17	17	4	8	12	26	NHL [0.2, 0.4)
19	Ryan Getzlaf	Calgary Hitmen	WHL	70	29	39	68	121	8	5	1	1	2	6	NHL [1.0, ...]
20	Brent Burns	Brampton Battalion	OHL	68	15	25	40	14	6	11	5	6	11	6	NHL [0.4, 0.6)
22	Marc-Antoine Pouliot	Rimouski Oceanic	QMJHL	65	32	41	73	100	-24	0	0	0	0	0	AHL [0.8, 1.0)
24	Mike Richards	Kitchener Rangers	OHL	67	37	50	87	99	35	21	9	18	27	24	NHL [1.0, ...]
25	Anthony Stewart	Kingston Frontenacs	OHL	68	32	38	70	47	-25	0	0	0	0	0	AHL [0.4, 0.6)
28	Corey Perry	London Knights	OHL	67	25	53	78	145	6	14	7	16	23	27	NHL [0.6, 0.8)
30	Shawn Belle	Tri-City Americans	WHL	66	7	14	21	77	-9	0	0	0	0	0	AHL [0.0, 0.2)
32	Ryan Stone	Brandon Wheat Kings	WHL	54	14	31	45	158	12	12	4	2	6	20	AHL [0.6, 0.8)
34	Mike Egener	Calgary Hitmen	WHL	40	2	8	10	210	-2	3	1	0	1	8	Other
37	Kevin Klein	Toronto St Michaels Majors	OHL	67	11	33	44	88	8	17	1	9	10	8	Other
38	Kamil Kreps	Brampton Battalion	OHL	53	19	42	61	12	19	11	3	5	8	4	NHL [0.2, 0.4)
40	Cory Urquhart	Montreal Rocket	QMJHL	71	35	43	78	28	5	7	9	6	15	6	AHL [0.4, 0.6)
42	Petr Vrana	Halifax Mooseheads	QMJHL	72	37	46	83	32	47	24	5	15	20	12	AHL [0.6, 0.8)
43	Josh Hennessy	Quebec Remparts	QMJHL	72	33	51	84	44	29	11	6	9	15	10	AHL [0.6, 0.8)
45	Patrice Bergeron	Acadie-Bathurst Titan	QMJHL	70	23	50	73	62	27	11	6	9	15	6	Other
46	Dan Fritsche	Sarnia Sting	OHL	61	32	39	71	79	6	5	2	2	4	4	NHL [0.2, 0.4)
49	Shea Weber	Kelowna Rockets	WHL	70	2	16	18	167	25	19	1	4	5	26	NHL [0.2, 0.4)
54	B.J. Crombeen	Barrie Colts	OHL	63	22	24	46	133	16	6	1	0	1	8	AHL [0.4, 0.6)
55	Stefan Meyer	Medicine Hat Tigers	WHL	70	36	16	52	90	-11	11	3	3	6	14	AHL [0.4, 0.6)
56	Patrick O'Sullivan	Mississauga IceDogs	OHL	56	40	41	81	57	-4	5	2	9	11	18	NHL [0.6, 0.8)
58	Jeremy Colliton	Prince Albert Raiders	WHL	58	20	28	48	76	-7	0	0	0	0	0	AHL [0.2, 0.4)
60	Marc-Andre Bernier	Halifax Mooseheads	QMJHL	67	29	29	58	43	5	21	9	8	17	8	Not_In_NHL_AHL
61	Maxim Lapierre	Montreal Rocket	QMJHL	72	22	21	43	55	13	7	1	3	4	6	NHL [0.2, 0.4)
63	Dave Liffiton	Plymouth Whalers	OHL	64	5	11	16	139	15	18	1	3	4	29	AHL [0.0, 0.2)
66	Masi Marjamaki	Red Deer Rebels	WHL	65	15	20	35	56	15	23	1	2	3	20	Not_In_NHL_AHL
68	Jean-Francois Jacques	Baie-Comeau Drakkar	QMJHL	67	12	21	33	123	12	12	4	2	6	13	AHL [0.6, 0.8)
69	Colin Fraser	Red Deer Rebels	WHL	69	15	37	52	192	24	22	7	6	13	40	AHL [0.4, 0.6)
70	Jonathan Filewich	Prince George Cougars	WHL	51	27	27	54	45	0	5	1	1	2	2	AHL [0.4, 0.6)
73	Daniel Carcillo	Sarnia Sting	OHL	68	29	37	66	157	11	6	0	4	4	14	NHL [0.4, 0.6)
74	Clarke MacArthur	Medicine Hat Tigers	WHL	70	23	52	75	104	-27	11	3	6	9	8	AHL [0.8, 1.0)
76	Richard Stehlik	Sherbrooke Castors	QMJHL	43	8	16	24	105	0	12	1	5	6	20	Other
77	Tyler Redenbach	Swift Current Broncos	WHL	60	17	51	68	35	-2	4	0	4	4	4	AHL [0.2, 0.4)
85	Alexandre Picard	Halifax Mooseheads	QMJHL	71	4	30	34	64	31	25	1	5	6	14	AHL [0.6, 0.8)
88	Zack Fitzgerald	Seattle Thunderbirds	WHL	64	8	14	22	232	11	15	0	4	4	33	AHL [0.0, 0.2)
89	Paul Brown	Kamloops Blazers	WHL	67	21	35	56	229	15	6	3	0	3	20	Other
94	Zack Stortini	Sudbury Wolves	OHL	62	13	16	29	222	-25	0	0	0	0	0	NHL [0.0, 0.2)
95	Rick Kozak	Brandon Wheat Kings	WHL	38	9	6	15	87	-2	16	6	5	11	51	Not_In_NHL_AHL
97	Ryan Donally	Windsor Spitfires	OHL	65	11	15	26	108	3	7	0	1	1	8	Not_In_NHL_AHL
102	Aaron Dawson	Peterborough Petes	OHL	65	1	8	9	76	-14	7	0	0	0	8	Not_In_NHL_AHL
104	Philippe Dupuis	Hull Olympiques	QMJHL	68	22	34	56	89	4	20	2	4	6	22	AHL [0.4, 0.6)
105	Martin Lojek	Brampton Battalion	OHL	65	1	13	14	47	17	11	0	1	1	6	AHL [0.0, 0.2)
110	Jim Sharrow	Halifax Mooseheads	QMJHL	70	2	14	16	54	0	25	2	4	6	24	AHL [0.4, 0.6)
111	Brandon Nolan	Oshawa Generals	OHL	68	36	52	88	57	1	13	10	7	17	4	AHL [1.0, ...]
112	Jamie Tardif	Peterborough Petes	OHL	68	31	29	60	32	3	7	3	4	7	0	AHL [0.4, 0.6)
113	Corey Locke	Ottawa 67s	OHL	66	63	88	151	83	46	23	19	19	38	30	AHL [0.8, 1.0)
116	Guillaume Desbiens	Rouyn-Noranda Huskies	QMJHL	64	15	18	33	233	-11	4	0	0	0	4	AHL [0.0, 0.2)
118	Frank Rediker	Windsor Spitfires	OHL	51	8	8	16	120	-14	7	0	2	2	10	Other
119	Nathan Saunders	Moncton Wildcats	QMJHL	69	1	13	14	241	9	6	2	3	5	12	Not_In_NHL_AHL
121	Paul Bissonnette	Saginaw Spirit	OHL	67	7	16	23	57	-10	0	0	0	0	0	AHL [0.0, 0.2)
123	Danny Stewart	Rimouski Oceanic	QMJHL	65	19	21	40	144	-43	0	0	0	0	0	Not_In_NHL_AHL
127	Alexandre Bolduc	Rouyn-Noranda Huskies	QMJHL	66	14	29	43	131	4	4	0	2	2	2	AHL [0.4, 0.6)
130	Matej Trojovsky	Regina Pats	WHL	70	3	6	9	229	-12	5	0	0	0	6	Other
131	David Svagrovsky	Seattle Thunderbirds	WHL	68	17	25	42	47	17	15	4	6	10	12	Not_In_NHL_AHL
132	Kyle Quincey	London Knights	OHL	66	6	12	18	77	6	14	3	4	7	11	AHL [0.2, 0.4)
149	Nigel Dawes	Kootenay Ice	WHL	72	47	45	92	54	2	11	4	8	12	6	NHL [0.4, 0.6)
158	John Mitchell	Plymouth Whalers	OHL	68	18	37	55	31	18	18	2	10	12	8	AHL [0.6, 0.8)
163	Brad Richardson	Owen Sound Attack	OHL	67	27	40	67	54	-10	4	1	1	2	10	AHL [1.0, ...]
164	Ryan Oulahen	Brampton Battalion	OHL	61	21	22	43	6	20	11	2	1	3	2	AHL [0.4, 0.6)
168	Marc Methot	London Knights	OHL	68	2	13	15	46	0	14	2	4	6	6	AHL [0.2, 0.4)
172	Pavel Voroshnin	Mississauga IceDogs	OHL	68	9	27	36	81	-6	1	0	0	0	2	Other
173	Tyler Johnson	Moose Jaw Warriors	WHL	49	8	6	14	39	4	13	2	1	3	9	Other
178	Ryan Gibbons	Seattle Thunderbirds	WHL	67	9	6	15	91	7	15	3	1	4	22	Other
182	Bruno Gervais	Acadie-Bathurst Titan	QMJHL	72	22	28	50	73	47	11	3	5	8	14	NHL [0.2, 0.4)
183	Nate Thompson	Seattle Thunderbirds	WHL	61	10	24	34	48	7	15	5	4	9	6	AHL [0.4, 0.6)
185	Francis Wathier	Hull Olympiques	QMJHL	72	9	18	27	143	5	20	1	6	7	20	Other
188	Mark Flood	Peterborough Petes	OHL	68	5	24	29	18	10	7	1	2	3	0	AHL [0.4, 0.6)
192	Doug O'Brien	Hull Olympiques	QMJHL	71	10	34	44	102	35	19	3	12	15	18	Not_In_NHL_AHL
198	Shay Stephenson	Red Deer Rebels	WHL	67	17	15	32	84	16	23	6	5	11	33	Not_In_NHL_AHL
201	Jonathan Tremblay	Acadie-Bathurst Titan	QMJHL	62	0	1	1	232	-10	9	0	0	0	45	Other
202	Nathan Paetsch	Moose Jaw Warriors	WHL	59	15	39	54	81	5	13	3	10	13	6	NHL [0.0, 0.2)
206	Thomas Bellemare	Drummondville Voltigeurs	QMJHL	67	5	3	8	474	-12	0	0	0	0	0	Other
208	Randall Gelech	Kelowna Rockets	WHL	67	25	20	45	93	31	19	8	4	12	17	AHL [0.2, 0.4)
214	Kyle Brodziak	Moose Jaw Warriors	WHL	72	32	30	62	84	4	13	5	3	8	16	NHL [0.2, 0.4)
215	Mathieu Roy	Val dOr Foreurs	QMJHL	52	11	21	32	164	17	7	1	0	1	8	AHL [0.4, 0.6)
219	Adam Courchaine	Vancouver Giants	WHL	71	43	42	85	24	-7	4	2	1	3	2	Not_In_NHL_AHL
220	Jeremy Williams	Swift Current Broncos	WHL	72	41	52	93	117	17	4	1	0	1	6	AHL [0.6, 0.8)
222	Francois-Pierre Guenette	Halifax Mooseheads	QMJHL	72	38	49	87	24	53	24	10	17	27	12	Not_In_NHL_AHL
223	Dany Roussin	Rimouski Oceanic	QMJHL	71	20	34	54	87	-23	0	0	0	0	0	Not_In_NHL_AHL
228	Will Colbert	Ottawa 67s	OHL	56	1	6	7	23	10	23	1	5	6	7	Not_In_NHL_AHL
229	Stephen Dixon	Cape Breton Screaming Eagles	QMJHL	72	28	42	70	54	-36	4	0	0	0	6	AHL [0.4, 0.6)
233	Mathieu Gravel	Shawinigan Cataractes	QMJHL	72	24	26	50	60	-6	6	2	2	4	2	Not_In_NHL_AHL
237	Shaun Landolt	Calgary Hitmen	WHL	75	15	25	40	71	3	5	0	1	1	6	Not_In_NHL_AHL
240	Cam Cunning	Kamloops Blazers	WHL	71	7	13	20	54	13	6	1	0	1	2	AHL [0.2, 0.4)
241	Jimmy Bonneau	Montreal Rocket	QMJHL	65	1	5	6	261	-1	7	0	0	0	12	Other
245	Dustin Byfuglien	Prince George Cougars	WHL	56	10	29	39	78	11	5	1	3	4	12	NHL [0.4, 0.6)
247	Benoit Mondou	Shawinigan Cataractes	QMJHL	60	11	51	62	33	9	9	3	8	11	8	AHL [0.4, 0.6)
250	Shane O'Brien	Toronto St Michaels Majors	OHL	62	16	26	42	198	-21	19	4	10	14	79	NHL [0.2, 0.4)
251	Mathieu Melanson	Chicoutimi Sagueneens	QMJHL	69	20	27	47	62	-16	4	0	0	0	14	Not_In_NHL_AHL
254	Nathan McIver	Toronto St Michaels Majors	OHL	68	5	10	15	121	5	19	0	4	4	41	AHL [0.0, 0.2)
257	Darryl Yacboski	Regina Pats	WHL	37	2	3	5	63	1	0	0	0	0	0	Other
258	Vladimir Kutny	Quebec Remparts	QMJHL	66	7	12	19	37	1	11	0	1	1	2	Not_In_NHL_AHL
261	Joey Tenute	Sarnia Sting	OHL	68	41	71	112	75	36	3	1	2	3	0	AHL [0.6, 0.8)
262	Ryan Rorabeck	Toronto St Michaels Majors	OHL	55	11	19	30	20	-10	19	4	9	13	10	Other
264	John Hecimovic	Sarnia Sting	OHL	60	30	32	62	112	25	6	4	2	6	6	Not_In_NHL_AHL
266	Louis-Philippe Martin	Baie-Comeau Drakkar	QMJHL	65	23	53	76	63	25	12	5	8	13	6	Not_In_NHL_AHL
278	Troy Bodie	Kelowna Rockets	WHL	35	4	4	8	36	2	11	1	1	2	2	AHL [0.2, 0.4)
279	Mark Olafson	Kelowna Rockets	WHL	50	4	8	12	109	-1	19	2	4	6	20	Not_In_NHL_AHL
281	Jean-Michel Bolduc	Quebec Remparts	QMJHL	68	5	14	19	164	17	10	0	0	0	37	Other
283	Trevor Hendrikx	Peterborough Petes	OHL	56	1	8	9	128	-9	7	0	0	0	4	Not_In_NHL_AHL
285	Matthew Hansen	Seattle Thunderbirds	WHL	51	3	18	21	24	21	15	0	5	5	2	Other
286	Zbynek Hrdel	Rimouski Oceanic	QMJHL	65	10	14	24	131	-60	0	0	0	0	0	Other
287	Nick Tarnasky	Lethbridge Hurricanes	WHL	69	9	20	29	84	-9	0	0	0	0	0	NHL [0.0, 0.2)
